id,date,carbon_kg,expenditure,normal,savings
1,Jan-1,435,121800,143724,21924
2,Feb-1,439,122920,141358,18438
3,Mar-1,432,120960,143942,22982
4,Apr-1,425,119000,140420,21420
5,May-1,418,117040,132255,15215
6,Jun-1,419,117320,131398,14078
7,Jul-1,416,116480,138611,22131
8,Aug-1,406,113680,131869,18189
9,Sep-1,410,114800,132020,17220
10,Oct-1,401,112280,132490,20210
11,Nov-1,398,111440,124813,13373
12,Dec-1,391,109480,124807,15327