id,date,carbon_kg,expenditure,normal,savings
1,2024-01-01,435,121800,144942,23142
2,2024-02-01,439,122920,142587,19667
3,2024-03-01,432,120960,146362,25402
4,2024-04-01,425,119000,143990,24990
5,2024-05-01,418,117040,139278,22238
6,2024-06-01,419,117320,136091,18771
7,2024-07-01,416,116480,133952,17472
8,2024-08-01,406,113680,135279,21599
9,2024-09-01,410,114800,135464,20664
10,2024-10-01,401,112280,126876,14596
11,2024-11-01,398,111440,125927,14487
12,2024-12-01,391,109480,130281,20801